#####################################
#-------#---#-#-----#-#-#---#-#-----#
###-#-#####-#-#-#-###-#-#-#-#-###-#-#
#---#-#-------#-#-#---#-#-#-----#-#-#
#-#-#-#####-###-###-#-#-###-###-#-###
#-#-#-#---#---#-----#-----#-#-------#
#-###-#-#-###-#-#######-#-#-###-###-#
#-#---#-#-----#-#-#-#---#-----#---#-#
#####-###-#-#-#-#-#-#-###-#-#-#-###-#
#---#-#---#-#-#---#-#-#-#-#-#-#-#---#
#-###-###-#-#-#-###-#-#-#-#########-#
#---#-#---#-#-#-#-#-#-#-------#-----#
#-###-###-###-#-#-#-###-#-###-#####-#
#---------#-#-#-#---#---#-#-------#-#
#-#-###-#-#-#-#-#-###-#######-#-#-###
#-#-#---#---#-#---#-#-#-----#-#-#-#-#
#-###-###-#-#-#-###-#-#-###-#-#-#-#-#
#---#-#---#-#-#---#---#---#---#-#---#
#-#######-#-#-#-#-###-#-#-###-#-###-#
#---#-----#-#-#-#-#-#-#-#---#-#---#-#
###-#####-#-#-###-#-#######-###-#####
#-----#---#-#-------#---------#-----#
#####################################
